111111111111111111111111111111
1P0000000000000000000000000001
1011111C010000C0000010C1111101
10100000C100000000001C00000101
1C1000011111000000111110000101
10100000010000C000001000000101
101000000100000000001000000101
10000001111100C000111110000001
101000000100000000001000000101
10100000C10000C000001C00000101
101000011111000000111110000101
101000000100000000001000000101
1C11111C010000C0000010C11111C1
100000000000000000000000000001
1C00000000000000000000000000E1
111111111111111111111111111111