1111111111111
10010000001C1
1100011111011
1P1011E100001
1111111111111
