1111111111111
1P1C0010000E1
1010101011111
10101010001C1
1010101110101
1000100000001
1111111111111