1111111111111
1P001010000C1
1010000011001
101011E000001
1111111111111