1111111111111
10000010C1001
1010X0001C001
10XC110100101
1001010X00101
1100P1000E0C1
1111111111111