1111111111111
10C10C10C1C01
10110110X1101
10X0000000001
1010111101101
1P001E000XC01
1111111111111