111111111111111111111111111111
1P10001C0100010100000000000001
101010110101010101111110111101
101C100101010100010010001E0101
101110010101010101001000110101
101C10010101010101001000110101
1010100001010101C1000000100101
101011110101011111111110101101
101000000101000000000000101101
101011110101111111111111100101
10101000010000000000000C110101
101011111101111111111111110101
1010000000000000000000001C0001
101111110111111111111111101111
1000000000000000000000000000C1
111111111111111111111111111111