1111111111111
1001CCCCCCCC1
100CC11110C01
1P0C11ECCCC01
1111111111111
