1111111111111
1X010000000C1
1X0001111X0X1
1P0011E000001
1111111111111
